 cloning into https://github.com/Brijeshrangdal/pps-test1...
remote: Enumerating objects: 31, done.        
remote: Counting objects: 100% (31/31), done.        
remote: Compressing objects: 100% (17/17), done.        
remote: Total 31 (delta 11), reused 29 (delta 9), pack-reused 0        
From https://github.com/Brijeshrangdal/pps-test1
 * [new branch]      main       -> origin/main
  HEAD branch: main
Already on 'main'
Branch 'main' set up to track remote branch 'main' from 'origin'.
gcc -g p10original.c
 gdb a.out
GNU gdb (Ubuntu 8.1.1-0ubuntu1) 8.1.1
Copyright (C) 2018 Free Software Foundation, Inc.
License GPLv3+: GNU GPL version 3 or later <http://gnu.org/licenses/gpl.html>
This is free software: you are free to change and redistribute it.
There is NO WARRANTY, to the extent permitted by law.  Type "show copying"
and "show warranty" for details.
This GDB was configured as "x86_64-linux-gnu".
Type "show configuration" for configuration details.
For bug reporting instructions, please see:
<http://www.gnu.org/software/gdb/bugs/>.
Find the GDB manual and other documentation resources online at:
<http://www.gnu.org/software/gdb/documentation/>.
For help, type "help".
Type "apropos word" to search for commands related to "word"...
Reading symbols from a.out...done.
(gdb) b main
Breakpoint 1 at 0x772: file p10original.c, line 3.
(gdb) r
Starting program: /home/runner/pps-test1-25/a.out 
warning: Error disabling address space randomization: Operation not permitted

Breakpoint 1, main () at p10original.c:3
3   {
(gdb) n
5     printf("my first number is\n");
(gdb) 10
Undefined command: "10".  Try "help".
(gdb) n
my first number is
6     scanf("%d",&a);
(gdb) 10
Undefined command: "10".  Try "help".
(gdb) n
10
7     printf("my second number is\n");
(gdb) n
my second number is
8     scanf("%d",&b);
(gdb) n
10
9     sum=a+b;
(gdb) n
10    printf("sum of the numbers is %d",sum);
(gdb) n
11    return 0;
(gdb) n
12    }
(gdb) 
